type octile
height 1
width 10
map
..........

